                NO      ./textures/wall_1.xpm
SO               ./textures/wall_2.xpm
                       
          WE ./textures/wall_3.xpm
               
EA ./textures/wall_4.xpm


F 34,34,34


C 135,206,235


111111111111111111111111111111111
100000000000000000000000000000001
100000000000000000000000000000001
100000000000000000100000000000001
100000000000010000010000000000001
100000000000000000001000000000001
1000000000000000N0010000000000001
100000000000000000000000000000001
111111111111111111111111111111111
