                NO      ./textures/mossy.xpm
SO               ./textures/redbrick.xpm
                       
          WE ./textures/bluestone.xpm
               
EA ./textures/colorstone.xpm

F 0,255,0

C 56,255,230

111111111111111111111111111111111
100000000000000000000000000000001
100000000000000000000000000000001
100000000000000000010000000000001
100000000000010000001000000000001
100000000000000000000100000000001
1000000000000000N0000010000000001
100000000000000000000000000000001
111111111111111111111111111111111